111111111111111111111111111111111111
100000000000000000000000000000000001
100200000000010000000000000000000001
100000000000010000000000000000000001
100000000000010000000000000000000001
100000000000010000000000000000000001
100000000000011111111111000000000001
100000000000010000000000000000000001
100000000000010000000000000000000001
100000000000010000000000000000000001
100000000000010000000000000000000001
100000000000010000000000011111111111
100000000000010000000000000000000001
100000000000010000000000000000000001
100000000000010000000000000000000001
100000000000000000000000000000030001
111111111111111111111111111111111111